111111111111111111111111111111111111111
1000000P000X000000000000001111111111111
10000000000X00000C00XXXX001111111111111
10000000000X00000000X0C0001111111111111
10000000000XX0000000X000001111111111111
1000000000000X000000XE00001111111111111
10000000000000XXXXXXX000001111111111111
100000000000000000000000001111111111111
111111111111111111111111111111111111111
111111111111111111111111111111111111111
111111111111111111111111111111111111111
111111111111111111111111111111111111111
111111111111111111111111111111111111111
111111111111111111111111111111111111111
111111111111111111111111111111111111111
111111111111111111111111111111111111111
111111111111111111111111111111111111111
111111111111111111111111111111111111111
111111111111111111111111111111111111111
111111111111111111111111111111111111111
111111111111111111111111111111111111111
