1111111111111111111111
1P11111111111111111111
1011111111111111111111
1011111111111111111111
1000000000000011111111
1011111111111111111111
1011111111111111111111
1011111111111111111111
1011111111111111111111
1011111111111111111111
1011111111111111111111
1111111111111111111111
