111111111111111111111111111
111111111111XEX111111111111
111111111111X00111111111111
111111111111000111111111111
1111111111110C0111111111111
111111111111000111111111111
1111111111110C0111111111111
111111111111000111111111111
1111111111110C0111111111111
111111111111000111111111111
1111111111110C0111111111111
111111111111000111111111111
1111111111110C0111111111111
111111111111000111111111111
1111111111110C0111111111111
111111111111000111111111111
1111111111110P0111111111111
111111111111111111111111111
