1111111111111111111111
11C0000001111111P11111
11111111000010000000C1
1111111111100011111111
1111111111111000EC1111
1111111111111111111111
